############
#          #
#   X     O#
# O    PX  #
#          #
############
