############
#          #
# O  X     #
#   P      #
############
