############
#        O #
#    P  ####
#          #
#          #
########   #
#  O  ##   #
#     ##   #
#          #
#       XX #
#       #  #
############
